Hau - Привіт/Добрий день
Fedu - Бувай/Папа/Прощавай/До побачення
Ki - Як
Fau - Справи/Справа
Piñ - Добре/Гаразд
Džoki - Поганo/Зло
Jintio - Йди в дупу/Іди в дупу/Йди у дупу/Іди у дупу/Пішов нахуй
Ķ - Я
Hî - Ти/Ви/Вас/Твій
Jug - Вони/Їм
Haž - Ми/Нас/Наш/Наше/Нам
kindraz - Дрочити/Дрочу/Дрочиш/Дрочимо/Дрочить/Дрочив
baźr - Дивитись/Бачив
ťoñq - Мова/Мови
Fabeñ - Болото/росія
Ŝmet - Лайно/Гівно
Blót - Сьогодні
Paźport - паспорт/паспорти
Cèliat - громадянин/громадяни
Oluheniá - Олухенія
Laùmen - Любити/Люблю/Любиш/Любить
Czèrki - Підпис/Підписи
Kit - Ім'я/Імені
Sekit - Прізвищe
Shynite - По-батькові
Shyn - Батько/Тато/Батя
Mati - Матір/Мама
Dati - Дата
Arc - Народження
Foto - Фото/Фотографія
Kam - Син/Сини
Huki - Бог/Бога/Богу
Bradit - Хлопець
Migduĺ - Дівчина
Emo - Нуль/Нуля
Ar - Один/одного
Se - Два/двох
To - Три/трьох
Qu - Чотири/чотирьох
Ho - П'ять/п'яти
Lo - Шість/Шести
Vi - Сім/семи
By - Вісім/восьми
Ku - Дев'ять/дев'яти
Ci - Десять/Десяти/Десяток
Registrati - Реєстрація
Blótak - День/Дні/Днів
Jéw - Так
Diz - Ні/Не
Bazard - Пароль
Igdol - Нога/Ноги/Нозі
Hvuit - Cтать
Tux - Чоловік/Чоловіки
Istofy - Жінка/Жінки
Ovyvoh - Небінарний/Небінарна
Itòfik - Вибач/Вибачте/Пробачте
Cyi - Хотіти/Хочу/Хочеш/Хочемо/Хоче/Хочуть
Rojk - Бути/Є/Був/Буду
Kòbi - Смерть/Померти/Мертвий
Úuuuu - Вазонок/Ваза
Kali - Погоджуюсь/Погоджуватися/Згода
Nitewaq - Умови/Умова
Etadon - Закон/Закони
O - і
Dewritò - Територія/Території
Itce - Немає/Нема/Відсутні/Відсутня
Crok - Помилка/Помилки
Taurus - Нескінченність/Безкінечність
Rokol - Герб/Символ
Toki - Місто/Міста
Cebàwrito - Країна/Країни
Ceba - Чиясь/Чиєсь/Чиїсь/Чийсь
Plúta - Прапор/Прапори
Kulbas - Пес/Пси
Koź - Кіт/Коти
Puk - Іронія/Іронізувати
Ràbi - Говорити/Говорю/Говоритиму/Говорив
Zitóta - Розташоване/Розташовуватися/Розташовано/Розташована
Ot - На
Git - Біля/Недалеко/Близько
Abeĺ - Село/Села
Tewot - Більшість
E - У/В
Norfolk - Ліс/Ліси
Wud - Має/Мати/Маю/Мав/Матиму
Gojot - Регіон
Hòzdi - Приклад
Źoe - Мені
Źoa - Мене/Мною
Diķiz - Вводити/Ввести/Ввів/Ввела
Úlfrat - Податок/Податки
Hax - Секунда
Grot - Хвилина
Fawer - Година
Aia - Тиждень
Weta - Місяць
Trata - Рік
Toq - Століття
Obraź - Валюта
Oluobraź - Олуобрац/Валюта Олухенії
Mjoka - Милий/Мила/Милі
Rota - Верх/Вверх
Meta - Низ/Вниз/Донизу
Vojana - Парк/Парки
Ķobañ - Платити/Плачу/Платило
Itcede - Невідомо/Невідомий/Невідоме
Won - Вже/Уже
Akaunt - Акаунт
Lica - Новини
Yuma - Дякую/Спасибі
Hoh - Теж/Також/Тоже
Qudimafu - Краш/Красивий
Hinemjoka - Поганий/Погана/Погане/Лох
Piktura - Зображення/Картинка
Ecuqoda - Кумис
Tota - Довгий/Довгі/Довге/Довга
Lono - Короткий/Коротка/Коротке
Chrzo - Член/Пісюн/Хуй/Члена/Члену
Tucho - Сім'я/Сім'ї
Liketa - Машина/Автомобіль
Toketa - Літак/Літаки
Voketa - Танк/Танки
Fyciryk - Терорист/Терористи
Jojo - Яйце
Nogdol - Рука/Руки
Waži - Молитва/Молитися
Rovio - Колись/Раніше/В минулому
Geź - В майбутньому/Потім/Пізніше
Qema - Тепер/Зараз
Sonao - Зошит/Записник/Блокнот
Komi - Понеділок
Etchi - Вівторок
Jodni - Середа
Fifido - Четвер
Waźiblótak - П'ятниця
Hedin - Субота
Sproti - Неділя